+++++++++++++++++++
+0A               +
+              ++++
+                 +
+              ++A+
+               +a+
+++++++++++++++++++
